111111111111
100C00000001
100E000P0001
111111111111
