11111111111
1000P000001
1000E00C001
11110111111
10000000001
1000C000001
11111111111
