111111111111
1OOOOOPOOOO1
1OCOOOOOOEO1
111111111111
