11111111111111111111
10000000000000000001
1CC1111111111111CCC1
1CCCCCCCCCC11CCCCCC1
1CCCPCCCCCC11CCCCCC1
1CCCCCCCCCC11CCCCCC1
1CCCCCCCC1111CCCCCE1
1C000000000000000001
1CCCCCCCCCCCCCCCCCC1
1CCCCCCCCCCCCCCCCCC1
11111111111111111111
