1111111111111111111111111111
10P0000000000000000000000E01
1111111111111111111111111111
