1111111111111
10000000C0001
1000C0000C001
10000P0000001
1111111111111
