1111
1C01
1001
1001
10C1
1E01
1111
