1111111111111111111
1P00000000000C00001
10P00000000000C00E1
100P00000000000C001
1111111111111111111
