1111111
1E000E1
100C001
1000001
100P001
1000001
100C001
1E000E1
1111111
