11111111111111111111111111111
10000000000000010000000000001
10011111111111110000001111C01
10000000000010000000001001001
1000P0000000100000C0001111001
10000000000010000000001110011
10000000011110000000001000011
11000000000000000000001000001
11111111000000000000000000001
11001111000000000000000000001
11011100000001111111000000001
11110000000001000001000000001
11100C000000010E0000000000C01
11000000000001000000000000001
11111111000000000001111111111
10000C01000000000000000000001
10000000000000000000000000001
11111111111111111111111111111
