11111111111111111111111111111
10000000000000110000000000001
10011111111111110000001111C01
10000000000110000000001111001
1000P0000001100000C0001111001
10000000000110000000001110011
10000000011110000000001000011
11000000000000000000001000001
11111111000000000000000000001
11111111000000000000000000001
11111100000001111111000000001
11110000000001000001000000001
11100C000000010E0000000000C01
11000000000001000000000000001
11111111000000000001111111111
11111111111111111111111111111
