1111111111
100P000001
100000C001

1000000001
100E00C001
1000000001
1111111111
