1111111111
1000C00001
1110000001
10000P0001
1111111111
1000000001
10E0000001
1111111111
