1111111111111111111
11000C000001000C001
1000000000011111111
1P000000C0000000E01
1111111111111111111
