1111111111111111111
100000100000C1E0001
100C000000000010001
1000001000001000001
1100011111111111111
1C0001
100001
100P01
111111
