1111111100011111
10P000000E0000C1
1111111111111111
